{
	"Name":"LightsTest",

	"Briefing":
		[
			""
		],

	"LevelMap":
		[
			"╔═══════════════════╗",
			"║X                 1║",
			"║                   ║",
			"║                   ║",
			"║                   ║",
			"║         +         ║",
			"║         Ð         ║",
			"║                   ║",
			"║                   ║",
			"║                   ║",
			"╚═══════════════════╝"
		],

	"Outro":
		[
			""
		]
}