{
	"Name":"TestLevel",

	"Briefing":
		[
			""
		],

	"LevelMap":
		[
			"╔═════╦═════════╦═════╦══════════════════════════════════╗",
			"║                     ║                                  ║",
			"║     ║         ║     ║                                  ║",
			"╠═════╝    *    ╚═════╣                                  ║",
			"║                     ║                                  ║",
			"║     X                                                  ║",
			"║                            A      a      à       C     ║",
			"║    ¶   ¶  ¹  ¹      ║      E      e      è       +     ║",
			"║                            I    * i      ì             ║",
			"║      ¹  ²  ³        ║      O      o      ò       Ð     ║",
			"║                            U      u      ù             ║",
			"║    $ $ £ £ € €             Y      y      ÿ             ║",
			"║                     ║                                  ║",
			"╠════════  ═══════════╩══════════════════════════════════╣",
			"║                                                        ║",
			"║                                                        ║",
			"║ ╔═════╗                                                ║",
			"║ ║b  Bb║                                                ║",
			"║ ║                                                      ║",
			"║ ║b   b║                                                ║",
			"║ ╚═════╝                            *            D      ║",
			"║                                                        ║",
			"║                              *                         ║",
			"║                                                        ║",
			"║                                                        ║",
			"║                                                        ║",
			"║                                                        ║",
			"╚════════════════════════════════════════════════════════╝"
		],

		"Messages":
		[
			""
		],

	"Outro":
		[
			""
		]
}